  

NO ./assets/textures/brickwall.xpm
SO ./assets/textures/brickwall.xpm
WE ./assets/textures/brickwall.xpm
EA ./assets/textures/brickwall.xpm
F 10,10,10
C 100,120,140
11111111
10010001
10010E011111
100000020001
111000111111
  11111


