C     150,150,150

NO    ./assets/textures/brickwall.xpm


F 80,20,20

EA ./assets/textures/brickwall.xpm

SO ./assets/textures/brickwall.xpm
WE ./assets/textures/brickwall.xpm

    11111111111
1111100000001Z111
1000000001ZZZZ101
101211110111111211111111
1020Z00E020Z020Z00020001
121112110111111211111101
1020Z000020000101    101
11111111110Z001011111101
         1000Z1000000001
         111111111111111