C     150,150,150

NO    ./assets/textures/brickwall.xpm


F 80,20,20

EA ./assets/textures/brickwall.xpm

SO ./assets/textures/brickwall.xpm
WE ./assets/textures/brickwall.xpm


111111111111111111111111111111111111111111111
100000000000100000000000000010000000000000001
101111121110101111111111111010111111111111101
101000000010101000Z0000000101010000000000Z101
101000Z000202020000000000020201000Z0000000101
101000000010101000Z0000000101010000000000Z101
101111111110101111111121111010111121111111101
100000000000100000000000000010000000000000001
11121111111110000000Z000000011111111111121111
100000000000001111111111111000000000000000001
10111111111110100000Z000001011111011111111101
10100000Z0001020000000000020100Z1010000000101
10100Z00000010100000Z00000101000201000Z000101
101000000000101111111111111010001010000000101
101112111111100000000000000010001011111211101
100000000000001110111111101110001000000000101
111111111211101000000000000010001011111111101
10000000000010100000Z0000000100Z1010000000001
1011111111101010000000000000100010100000Z0001
101Z00000010101111121111121110001011111111101
101000Z00010100000000000000000001000000000001
101000000010101111111111111111111111111121111
101111211110101000000000000000000000000000001
1000000000001010000000Z000000N000000Z00000001
111111111111111000000000000000000000000000001
              1000000000000000000000000000001
              1ZZZZZZZZZZZZZZZZZZZZZZZZZZZZZ1
              1ZZZZZZZZZZZZZZZZZZZZZZZZZZZZZ1
              1ZZZZZZZZZZZZZZZZZZZZZZZZZZZZZ1
              1111111111111111111111111111111